W W W W W W W W W W W W W W W W W W W W 
W W X X X W X X W W W W X X W X X X W W 
W X X W X X W X X X W W X W X X W X X W 
W X W W W X X W W X W X X W X W W W X W 
W X W W X W X X W X X X W W X X X W X W 
W X X X X W W X W X W X X X X W X W X W 
W X W X W W W X X X W X W X W X W X X W 
W X X X W W W X W W W X W X W X X X W W 
W X W W W W W X X X W X X X X W W X W W 
W X X W W W X X W X X W X W X W X X X W 
W W X X X W X W W W X W W X X W X W X W 
W W W W X X W W W W X W X E W X X W X W 
W W W W W X X W W X X X X W W W X X X W 
W W W W W W X W X X W W X W W W W X W W 
W W W W W W X X W X W W W W W W X X X W 
W W W W W W W X X X W W W W W X X W X W 
W W W W W W X X W X X S W W W X W X X W 
W W W W W W X W X W W X X W X X X W X W 
W W W W W W X X X W W W X X X W X X X W 
W W W W W W W W W W W W W W W W W W W W 
