WWWWWWWWWWWWWWWWWWWWWWWWW
WXXXXXWXXXWXXXWXXXXWXXWXW
WXWXWXXWWXXSWXXXWWXXXWXXW
WXWXXWXWXXWXXWXWXXXWXXWXW
WXXWXXXEWWXWXWXXXWXXXWWXW
WWXWWXWXXWXXXWXWXXXWXXXXW
WWXXSXWWXWXWXXXXXWXXWWXWW
WWXWWXWWXXWWWXWWXXXWXXXXW
WXXXXXWWWXXWWXWXXWWXXWWXW
WXWXWWXXXWXXWXWXWWWXWWWXW
WXWXXXXWXXWXXXXXXWWXWWWXW
WXXWXWXXWXXXWWXWXXXXWWWXW
WWXWXXXWXWWXXXXXWXWWXXXXW
WWXWWWWXXWWXWWXWXXXXXWWXW
WWXXWWWWXXWEWXXWXWWWXXXXW
WXWXXXWWWXWXWXWXXXWWWXWXW
WXWXWXWWWXWXXWWXWXWWWXXXW
WXXXWXXXWXWWXXWXWXWWWXWXW
WWXWXXWXXXXXWXWXWXXWWXWXW
WXXXXWXXWWWXXXWXXWXXXXXXW
WXWXWXXWXXXXWXXWXXWWXWXWW
WXWXXXWWXWWXXWXXWXWWXXXWW
WXXWXWWXXXWWXXWXXXWWXWXWW
WWXXXXXXWXXXWXXXWXXXXXXXW
WWWWWWWWWWWWWWWWWWWWWWWWW
