WWWWWWWWWWWWWWWWWWWWWWWWW
WWXXXWWWWXXXWWXXXXXXXWXXW
WXXWXWWWXXWXXXXWXWXWXXXWW
WXWWWXXXWWXWXWXXXWXWXWWWW
WXXXXXWXWXXWWXXWWXXWXWWWW
WXWXWXWXWXWXXXWXXXWWXXWWW
WXSXWXWXXXXXWWXXWXXWWXWWW
WXWXXXXWXWWXXWXWWWXXXXXWW
WXXWXWXWXXWWXXXXXXXWXWXWW
WXWWWXXXWEXXWXWWWWXXXWXXW
WXXWWXWXWXWXXXXWWWWXWXWXW
WWXXWXWXXXXXWWXWWWWXXXXWW
WXWXXXWWXWXWWWXWWWWWXWXWW
WXWXWWXXXWXWWXXXWWWXXXXWW
WXXXWXXWXXXXWXWXWWXXWWXWW
WWWXXXWXXWXWXXWXWWXWWXXWW
WWWXWXXXWXXXWWWXXWXWXXWXW
WXXXWXWXWXWXWWWWWXXXXWXXW
WXWXXXWXXXXXXXWWXXWXWXXWW
WXXWWWXXWWXWWXXXXWWXXWXXW
WWXXWXWXWXXWXXWXWWWXWWWSW
WWWXXXWXXXWXXWWXWWWXWWWXW
WXXXWXWXWWXXWXWXWXXXXWXXW
WXWWWXXXEXXWXXXXXXWWXXXWW
WWWWWWWWWWWWWWWWWWWWWWWWW
