WWWWWWWWWWWWWWWWWWWWWWWWW
WWXXXWWWWXXXWWOOOOOOOWXXW
WXXWXWWWXXWXXXOWXWXWOXXWW
WXWWWOOOWWXWXWOXXWXWOWWWW
WOOOOOWOWXXWWOOWWXXWOWWWW
WOWXWXWOWXWOOOWXXXWWOOWWW
WOOOWXWOOOOOWWXXWXXWWOWWW
WXWOOOOWXWWXXWXWWWXXOOXWW
WXXWXWOWXXWWXXXXXXXWOWXWW
WXWWWXOOWEXXWXWWWWXOOWXXW
WXXWWXWOWXWXXXXWWWWOWXWXW
WWXXWXWOOOOXWWXWWWWOOXXWW
WXWXXXWWXWOWWWXWWWWWOWXWW
WXWXWWXXXWOWWXXXWWWXOOOWW
WXXXWXXWOOOXWXWXWWXXWWOWW
WWWXXXWOOWXWXXWXWWXWWOOWW
WWWXWOOOWXXXWWWXXWXWOOWXW
WOOOWOWXWXWXWWWWWOOOOWXXW
WOWOOOWXXXXXXXWWOOWXWXXWW
WOOWWWXXWWXWWXXOOWWXXWXXW
WWOOWXWXWXXWXXWOWWWXWWWSW
WWWOOOWXXXWXXWWOWWWXWWWOW
WXXXWOWXWWXXWXWOWOOOOWOOW
WXWWWOOOEXXWXXXOOOWWOOOWW
WWWWWWWWWWWWWWWWWWWWWWWWW
