WWWWWWWWWWWWWWWWWWWWWWWWW
WXXXXXWXXXWXXXWXXXXWXXWXW
WXWXWXXWWXXSWXXXWWXXXWXXW
WXWXXWXWXXWXXWXWXXXWXXWXW
WXXWXXXEWWXWXWXXXWOOOWWXW
WWXWWXWXXWXXXWXWOOOWOOOXW
WWXXSOWWXWXWXOOOOWXXWWOWW
WWXWWOWWXXWWWOWWXXXWOOOXW
WOOOOOWWWXXWWOWXXWWOOWWXW
WOWXWWXXXWXXWOWXWWWOWWWXW
WOWXXXXWXXWXXOOXXWWOWWWXW
WOOWXWXXWXXXWWOWXOOOWWWXW
WWOWXXXWXWWOOOOXWOWWOOOOW
WWOWWWWXXWWOWWXWXOOOOWWOW
WWOOWWWWXXWEWXXWXWWWXOOOW
WXWOOOWWWXWXWXWXXXWWWOWXW
WXWXWOWWWXWXXWWXWXWWWOOOW
WXXXWOOOWXWWXXWXWXWWWXWOW
WWXWXXWOOOOOWXWXWXXWWXWOW
WXXXXWXXWWWOOOWXXWXXOOOOW
WXWXWXXWXXXXWOOWXXWWOWXWW
WXWXXXWWXWWXXWOOWXWWOOOWW
WXXWXWWXXXWWXXWOOOWWXWOWW
WWXXXXXXWXXXWXXXWOOOOOOXW
WWWWWWWWWWWWWWWWWWWWWWWWW
